11111111111111111111111111111111
10001110000000000000000000000111
101C010000000000P000000000000111
10011110000000000000010001111111
11001110110000000000000001001111
1000000001110000000000000000E111
11111111111111111111111111111111
