1111111111111111111111111111111111
1000111000000000000000000000000111
101C1111000000000P0000000000000111
1001111000000000000000100001111111
1100111011000000000000000001000111
100000000011100000000000000000E111
1111111111111111111111111111111111
