111111111111111111111111111111
100011100000000000000C00000001
1010C1000000C000P0000000000001
100111100000000000000100011111
1100111011000C0000000000010011
1000000001110000000000C00000E1
111111111111111111111111111111
